##########################
#........................#
##.#####################.#
#..########.####.##....#.#
#.##....###.........####.#
#.#####.##..############.#
#.....#.##.######......#.#
##.##.#.##.#......####.#.#
#..##...##.#.####.#....#.#
#.####.###.###....######.#
#.####......#####.######.#
#......##########..#####.#
#.#########.######.....#.#
#.#########.######.#####.#
#........................#
#####################.####
#........................#
##########################
\robot 1 17
